Texture		Texture/map_rect002.bmp
TileWidth	32
TileMaxX	6
TileMaxY	6
TileNumX	14
TileNumY	9
   7   7   7   7   7   7   7   7   7   7   7   7   7   7
   7   3   4   4   5   7   7   7   7   7   7   7   7   7
   7   9  10  10  11   7   7   7   7   7   7   7   7   7
   7   9  10  10  12   4   4   5   7   7   3   4   5   7
   7   9  10  10  10  10  10  11   7   7   8  10  11   7
   7   9  10  10   0   1   2  11   7   7   8  10  11   7
   7   9  10  10  11   7   8  11   7   7   8  10  12   4
   7   9  10  10  11   7   8  12   4   4  14  10  10  10
   7  15  16  16  17   7   8  10  10  10  10  10  10  10
   
   
   
   
   
   
   
   
   
   
   
   
   
   
 